   **************************************************
*                                                   *
*                                                   *
*     ****                                 ****     *
*        *                                 *        *
*        *                                 *        *
*        *                                 *        *
*        *        *****************        *        *
*        *        *               *        *        *
*        *        |      $$$      *        *        *
*        *        |      $$$      *        *        *
*        *        |      $$$      *        *        *
*        *        *              #*        *        *
*        *        *****************        *        *
*        *                                 *        *
*        *                                 *        *
*        *                                 *        *
*     ****                                 ****     *
*                                                   *
*                                                   *
*****************************************************